1111111111
1001100001
10P0111001
1000000C01
1001100101
10100E0001
1011110001
1000010001
100C010C01
1111111111