1111111111111111111111111
1E0011001110000CC00CCC001
1001010000C000C0100001001
1011110011000CCCC00C10001
1P000C0011100000100CCC001
1111111111111111111111111
