1111111111111111111111111111111
100001C1111000000111111C1100001
10P001000000001000000C101100001
1011111111111110111111100000001
1001C11111111110000000111111001
1101000000000000111100000000001
1101111111111111111100001111111
1000001100010000000001100111C01
101110110C010111110000001001101
1011101101110001C10111111110101
1000000000000001010000000000001
1011111111110001000111110111111
100000C1000111111111111101E0001
1000011100000000000000000100001
1111111111111111111111111111111