1111111111
10E0000001
10E000PE01
10E0000001
1111111111